[Board]
23,24
XXXXXXXXXXXXXXXXXXXXXXX
X1111111111X1111111111X
X0XX1XXXX11X11XXXX1XX1X
X0XX1XX111111111XX1XX1X
X011B111111X111111B111X
X0XXXXXXX11X11XXXXXXX1X
X011X1111111111111X111X
X0111111111P1111111111X
X01XXXXXXXXXXXXXXXXX11X
X000000000011111111111X
X1111X1XXX011XXX1X1111X
XXXXXX1XXX0$1XXX1XXXXXX
X1111X1XXX111XXX1X1111X
X111111111111111111111X
X11XXX11111111111XXX11X
X11XXXXXXX1X1XXXXXXX11X
X111X111111X111111X111X
X111X11XXXXXXXXX11X111X
X111X111111X111111X111X
X111B111111X111111B111X
X1XX1XX1111X1111XX1XX1X
X1XX1XXXX11X11XXXX1XX1X
X1111111111X1111111111X
XXXXXXXXXXXXXXXXXXXXXXX

[Game]
title = Better than CSSE2010 Pacman
author = Annon
lives = 5
level = 0
score = 513
hunter = 10,11,DOWN,0,SPEEDY
blinky = 17,9,RIGHT,SCATTER:2
clyde = 1,10,DOWN,SCATTER:3
inky = 7,7,RIGHT,CHASE:16
pinky = 1,4,UP,FRIGHTENED:4

[Scores]
Evan : 112456
Peter : 100